XXXXXXXXXXXXXXXXXXXXXXXXXXX
XQQQXXXXQQQQQQQQQQQXXXXQQQX
XQXQOQTQQXXXXXXXXXQQTQOQXQX
XQXXXXX XXXQQQQQXXXXX XXXQX
XQQQGQMQQQTQXQXQTQQQQQGQQQX
XXXXXXXXXXXQQMQQX XXXXXXXXX
XQQGQQTQQQTQXQXQTQQQQQQGQQX
XQXXXXX XQX QQQQX XTXXXXXQX
XQOQQQXQXQXXXXXXXQXQ QQQOQX
XXQXXQXQQQQQQQQQQQXQXQXXQXX
XXXXXXXXXXXXXXXXXXXXXXXXXXX