XXXXXXXXXXXXXXXXXXXXXXXXXXX
XOQQQQQQQQQQQQQQQQQQQQQQQOX
XQXXTXXXXXXQXXXQXXXXXXTXXQX
XQXXQ QQQQXQQQQQXQQQQQQ XQX
XGQQQXQQQQXXXTXXXQQQQQQQXGX
XXXXXXXTXXXQQM QXXXTXXXXXXX
XGQQQQQQ QTQXQXQTQQQ QQQQGX
XQXXXXXXXQX QQQQX XXXXXXXQX
XQQQQQQQQXXXXXXXXXXQQQQQQQX
XOQXXQXQQQQQQQQQQQQQXQXXQOX
XXXXXXXXXXXXXXXXXXXXXXXXXXX