XXXXXXXXXXXXXXXXXXXXXXXXXXX
XOXXXXGQQQQQQQQQQQQQGXXXXOX
XQQQQQQXXXTXXXXXTXXXQQQQQQX
XQQXXXTQQQQ QQQQQ QQTXXXQQX
XXQQQXX XXXQQQQQXXXXQ QQQXX
XQQXXXQQQQQQXMXQQQQQQXXXQQX
XXQQQQQQXXXQQTQQXXXQQQQQQXX
XQQXXXTQQQQQQX QQQQQTXXXXQX
XQQQQQX XXXXXTXXXXXQQ QQQQX
XOXXXXGQQQQQQQ QQQQQGXXXXOX
XXXXXXXXXXXXXXXXXXXXXXXXXXX
