XXXXXXXXXXXXXXXXXXXXXXXXXXX
XQQQXXXXQQQQQQQQQQQXXXXQQQX
XQXQOQTQQXXXXXXXXXQQTQOQXQX
XQXXXXXQXXXQQQQQXXXXXQXXXQX
XQQQGQMQQQTQXQXQTQQQQQGQQQX
XXXXXXXTXXXQXMXQXQXXXXXXXXX
XQQGQQQQQQTQXQXQTQQQQQQGQQX
XQXXXXXQXQXQQQQQXQXTXXXXXQX
XQOQQQXQXQXXXXXXXQXQQQQQOQX
XXQXXQXQQQQQQQQQQQXQXQXXQXX
XXXXXXXXXXXXXXXXXXXXXXXXXXX