XXXXXXXXXXXXXXXXXXXXXXXXXXX
XOXXXXGQQQQQQQQQQQQQGXXXXOX
XQQQQQQTXXXXQXQXXXXTQQQQQQX
XQQXXXXtQQQQQXQQQQQtXXXXQQX
XXQQQQTXXXXQQQQQXXXXTQQQQXX
XQQXXXtQQQQQXMXQQQQQtXXXQQX
XXQQQQTXXXXQQQQQXXXXTQQQQXX
XQQXXXtQQQQQQXQQQQQQtXXXXQX
XQQQQQQQXXXXQXQXXXXQQQQQQQX
XOXXXXGQQQQQQQQQQQQQGXXXXOX
XXXXXXXXXXXXXXXXXXXXXXXXXXX
